11_ox
_o______o__o_______o_
__o___oo____________o
________o_o__oo______
____oo_____o_____ooo_
_o___o___________o_o_
oo_oo_________o____oo
__________________o__
_o_o_o_o____o___o____
__o_____o__o_________
_____oo___oo________o
___o_________________
