20_ox
_________o
_____o____
__o__o____
_o________
____o____o
__________
__________
__________
__oo____o_
_____o____
_o___o_o__
o__o______
o______o__
_____o____
o____o____
__________
o________o
___o__o___
_____o____
__________
