10.ox
....o..o..
.ooooo....
...o.....o
.......oo.
......o.o.
o..oo.....
.........o
.........o
ooo.......
...o...o..
