10_ox
ooo__ooo__
________o_
o_________
__o__o_o__
_oo__o____
_oo___o_o_
________o_
_____oo_o_
_______o__
___oo_____
