25.ox
..o......o....oo..o....o.
o...o...o......o..o....oo
.o.o.o...o..o......o...o.
.o..o..o.........o....o..
...o.....o...oo.o........
.....oo.........o..oo..o.
........o.o....o......oo.
........o....oo....o.oo..
...o...o.......o..o.....o
oo....oo.oo.........o.o..
.oo..o.....o......o......
...o..o.o....oo.......o..
..........o.......oo.....
..............ooooo..o.o.
...o........o.o....o.o..o
.......o..........ooo....
...o..o.ooo....o......o..
.o...o.......o...o...o..o
.........o.o.....o...o...
..ooo..................o.
....o...oo..o......oo.ooo
oo.o......o...o.o...oo.o.
...oo..o....oo...........
...o.o.........o.........
o..o....o..o..o.......o..
