10_ox
________o__o__o___o_
_o_o____o_____o_____
_ooo____oo_o___o__o_
__o____________o_o__
___o______o________o
o___o_____o________o
__o___oo_o__o_______
o______ooo____o_o_o_
_____o__o____o_oo___
_o________o_________
